%%%%%%%%%%%%%%%%%%%%%%
%    $$              %
%   $ E$             %
%    $$              %
%       $  %         %
%      $$$           %
%     $$B$$          %
%      $$$           %
%       $           $%
%           R      $E%
%%%%%%%%%%%%%%%%%%%%%%
