%%%%%%%%%%%%%%%%%%%%%%
%                    %
%                    %
%                    %
%                    %
%                    %
%                    %
%                    %
%                   $%
% B$$$$$$$$$$$$$$$$$E%
%%%%%%%%%%%%%%%%%%%%%%