%%%%%%%%%%%%%%%%%%%%%%%
%$$ $$ $$ $$$ $$ $$ $$%
%      $       $      %
%$$$$$$R       R$$$$$$%
%                     %
% $  $     T     $  $ %
%      $       $      %
%$$$$$$         $$$$$$%
%  V   $$$$$$$$$  V   %
% $ $ $         $ $ $ %
%  R     $ $ $    V   %
%$$$$$$         $$$$$$%
%          $         B%
%%%%%%%%%%%%%%%%%%%%%%%
