%%%%%%%%%%%%%%%%%%%%%%
%E                $  %
%          $$$$$$$$B %
%                 $  %
%     $    $         %
%     $      E    $  %
%     $              %
%   $$$   V          %
%           $$$$$$$  %
%B    $              %
%%%%%%%%%%%%%%%%%%%%%%
