%%%%%%%%%%%%%%%%%%%%%%
%B                   %
%         R       $  %
%          $$$$$$$$  %
%$$$$$$$$         $R %
%                 $  %
%   $$$$$$$$$        %
%                    %
%  R        $$$$$$$  %
%   $$$$$$$$$        %
%%%%%%%%%%%%%%%%%%%%%%
