%%%%%%%%%%%%%%%
%B  $$        %
%           B %
%            %%
%  B       %%%%
%          %%E%
%%%%%%%%%%%%%%%