%%%%%%%%%%%%%%%
%B  $$        %
%             %
%            %%
%          %%%%
%  B       %%E%
%%%%%%%%%%%%%%%