%%%%%%%%%%%%%%%
%B  $$        %
%             %
%       B    %%
%       %%%%%%%
%       %    E%
%%%%%%%%%%%%%%%