%%%%%%%%%%%%%%%
%B  $$        %
%             %
%            %%
%          %%%%
%           %E%
%%%%%%%%%%%%%%%