%%%%%%%%%%%%%%%
%B  $$        %
%             %
%            %%
%          %%%%
%          %%E%
%%%%%%%%%%%%%%%