%%%%%%%%%%%%%%%
%B  $$        %
%             %
%       B    %%
%          %%%%
%           %E%
%%%%%%%%%%%%%%%