%%%%%%%%%%%%%%%
%B  $$      B %
%             %
%            %%
%          %%%%
%            E%
%%%%%%%%%%%%%%%