%%%%%%%%%%%%%%%
%B            %
%             %
%             %
%             %
%            E%
%%%%%%%%%%%%%%%