%%%%%%%%%%%%%%%
%B            %
%             %
%             %
%            %%
%           %E%
%%%%%%%%%%%%%%%